777^7^^^7^7^^7^7^777^7^^^7^7^^7^7^777^7^^^7^7^^7^7^777^7^^^7^7^^7^7^777^7^^^7^7^^7^7^777^7^^^7^7^^7^7^777^7^^^7^7^^7^7^777^7^^^7^7^^7^7^777^7^^^7^7^^7^7^777^7^^^7^7^^7^7^777^7^^^7^7^^7^7^777^7^^^7^7^^7^7^^777^7^^^7^7^^^777^7^^^~~ ~~ ~~ ~~ ~~ ~~ ~~ ~~ ~~ ~~ ~~ ~~ ~~ 
777^7^^^7^7^^7^7^777^7^^^7^7^^7^7^777^7^^^7^7^^7^7^777^7^^^7^7^^7^7^777^7^^^7^7^^7^7^777^7^^^7^7^^7^7^777^7^^^7^7^^7^7^777^7^^^7^7^^7^7^777^7^^^7^7^^7^7^777^7^^^7^7^^7^7^777^7^^^7^7^^7^7^`````````````````````^^7^7^777^7^^^7^7^^~~ ~~ ~~ ~~ ~~ ~~ ~~ ~~ ~~ ~~ ~~ ~~ ~~ 
777^7^^^7^7^^7^7^777^7^^^7^7^^7^7^777^7^^^7^7^^7^7^777^7^^^7^7^^7^7^777^7^^^7^7^^7^7^777^7^^^7^7^^7^7^777^7^^^7^7^^7^7^777^7^^^7^7^^7^7^777^7^^^7^7^^7^7^777^7^^^7^7^^7^7^`````````#`````````````````````````````````````^7^^^7^7^^ ~~ ~~ ~~ ~~ ~~ ~~ ~~ ~~ ~~ ~~ ~~ ~~ ~ 
777^7^^^7^7^^7^7^777^7^^^7^7^^7^7^777^7^^^7^7^^7^7^777^7^^^7^7^^7^7^777^7^^^7^7^^7^7^777^7^^^7^7^^7^7^777^7^^^7^7^^7^7^777^7^^^7^7^^7^7^``````````````````````````````````````````#`````````````````````````````````````````````````~~ ~~ ~~ ~~ ~~ ~~ ~~ ~~ ~~ ~~ ~~ ~~   
777^7^^^7^7^^7^7^777^7^^^7^7^^7^7^777^7^^^7^7^^7^7^777^7^^^7^7^^7^7^777^7^^^7^7^^7^7^777^7^^^7^7^^7^7^```````````````````````````````````````````````````````````````````````````#````````````````````````````````````````````````````~~ ~~ ~~ ~~ ~~ ~~ ~~ ~~ ~~ ~~ ~~ ~~ 
777^7^^^7^7^^7^7^777^7^^^7^7^^7^7^777^7^^^7^7^^7^7^777^7^^^7^7^^7^7^```````````````````````````````````````````````````````````````````````````````````````````````````````````###````````````````````````````````````````````````````~~ ~~ ~~ ~~ ~~ ~~ ~~ ~~ ~~ ~~ ~~ ~~ 
777^7^^^7^7^^7^7^777^7^^^7^7^^``````````````````````````````````````````````````````````````````````````````````<---------------->````````````````````````````````````````````###`````````````````````````````````````````````````````~~ ~~ ~~ ~~ ~~ ~~ ~~ ~~ ~~ ~~ ~~ ~~ 
777^7^^^7^7^^7^7^```````````````````````````````````````````````````````````````````````````````````````````````|================|```````````````````````````````````````````###``````````````````````````````````````````````````````~~ ~~ ~~ ~~ ~~ ~~ ~~ ~~ ~~ ~~ ~~ ~~ 
777^7^^````````````````````````<------------------------>``````````````````````````````````````##################================|```````````````````````````````````````````###``````````````````````````````````````````````````````~~ ~~ ~~ ~~ ~~ ~~ ~~ ~~ ~~ ~~ ~~ ~~ 
7^7````````````````````````````|========================|``````````````````````````````````````##################================|```````````````````````````````````````````###```````````````````````````````````````````````````~~ ~~ ~~ ~~ ~~ ~~ ~~ ~~ ~~ ~~ ~~ ~~ ~~ 
7^`````````````````````````````|========================|``````````````````````````````````````##```````````````|================|```````````````````````````````````````````````````````````````````````````````````````````````````~~ ~~ ~~ ~~ ~~ ~~ ~~ ~~ ~~ ~~ ~~ ~~ ~
7^`````````````````````````````|========================|``````````````````````````````````````##```````````````<---------------->``````````````````````````````````<------------------------------>```````````````````````````````````````~~ ~~ ~~ ~~ ~~ ~~ ~~ ~~ ~~ ~~ ~~ ~~ ~~
7^7````````````````````````````<------------##---------->``````````````````````````````````````##`````````````````````````````````````#`#```````````````````````````|==============================|```````````````````````````````````````~~ ~~ ~~ ~~ ~~ ~~ ~~ ~~ ~~ ~~ ~~ ~~ ~~
7^``````````<------------>``````````````````##`````````````````````````````````````````````````##```````````````````````````````````##``````````````````````````````|==============================|```````````````````````````````````````~~ ~~ ~~ ~~ ~~ ~~ ~~ ~~ ~~ ~~ ~~ ~~ ~~
7^7`````````|============|``````````````````##`````````````````````````````````````````````````##```````````````````````````````````#`#`````````````````````````````|==============================|```````````````````````````````````````~~ ~~ ~~ ~~ ~~ ~~ ~~ ~~ ~~ ~~ ~~ ~~ ~~
7^``````````|============|``````````````````##`````````````````````````````````````````````````##```````````````````````````````````````````````````````````````````|==============================|````````````````````````````````````````~~ ~~ ~~ ~~ ~~ ~~ ~~ ~~ ~~ ~~ ~~ ~~ ~
7^``````````|=============##########################################################################################################################################===============================|```````````````````````````````````````~~ ~~ ~~ ~~ ~~ ~~ ~~ ~~ ~~ ~~ ~~ ~~ ~ 
7^``````````|=============##########################################################################################################################################===============================|```````````````````````````````````````~~ ~~ ~~ ~~ ~~ ~~ ~~ ~~ ~~ ~~ ~~ ~~ ~ 
7^7`````````|============|``````````````````##`````````````````````````````````````````###``````````````````````````````````````````````````````````````````````````|==============================|```````````````````````````````````````~~ ~~ ~~ ~~ ~~ ~~ ~~ ~~ ~~ ~~ ~~ ~~ ~ 
7^``````````|============|``````````````````##`````````````````````````````````````````###``````````````````````````````````````````````````````````````````````````|==============================|````````````````````````````````````````~~ ~~ ~~ ~~ ~~ ~~ ~~ ~~ ~~ ~~ ~~ ~~ ~
7^``````````<------------>``````````````````##```````````````````````````````````````<-###---------------------------------->```````````````````````````````````````|==============================|````````````````````````````````````````~~ ~~ ~~ ~~ ~~ ~~ ~~ ~~ ~~ ~~ ~~ ~~ ~
7^``````````````````````````````````````````##```````````````````````````````````````|======================================|```````````````````````````````````````|==============================|````````````````````````````````````````~~ ~~ ~~ ~~ ~~ ~~ ~~ ~~ ~~ ~~ ~~ ~~ ~
7^````````````````````````````````````<-----##------------->`````````````````````````|======================================|```````````````````````````````````````<------------------------------>````````````````````````````````````````~~ ~~ ~~ ~~ ~~ ~~ ~~ ~~ ~~ ~~ ~~ ~~ ~
7^````````````````````````````````````|====================|`````````````````````````|======================================|````````````````````````````````````````````````````````````````````````````````````````````````````````~~ ~~ ~~ ~~ ~~ ~~ ~~ ~~ ~~ ~~ ~~ ~~ ~
7^````````````````````````````````````|====================|`````````````````````````|======================================|``````````````````````````````````````````````````````````````````````````````````````````````````````````~~ ~~ ~~ ~~ ~~ ~~ ~~ ~~ ~~ ~~ ~~ ~~
7^````````````````````````````````````|====================|`````````````````````````|======================================|````````````````````````````````````````````````````````````````````````````````````````````````````````~~ ~~ ~~ ~~ ~~ ~~ ~~ ~~ ~~ ~~ ~~ ~~ ~
7^7```````````````````````````````````|====================|`````````````````````````|======================================|````````````````````````````````````````````````````````````````````````````````````````````````````````~~ ~~ ~~ ~~ ~~ ~~ ~~ ~~ ~~ ~~ ~~ ~~ ~
7^````````````````````````````````````<-------------------->`````````````````````````|======================================|``````````````````````````````````````````````````````````````````````````````````````````````````````````~~ ~~ ~~ ~~ ~~ ~~ ~~ ~~ ~~ ~~ ~~ ~~
7^```````````````````````````````````````````````````````````````````````````````````|======================================|```````````````#```````````````````````````````````````````````````````````````````````````````````````~~ ~~ ~~ ~~ ~~ ~~ ~~ ~~ ~~ ~~ ~~ ~~ ~~
7^```````````````````````````````````````````````````````````````````````````````````<-------------------------------------->``````````````#`#`#```````````````````````````````````````````````````````````````````````````````````~~ ~~ ~~ ~~ ~~ ~~ ~~ ~~ ~~ ~~ ~~ ~~ ~~~
7^````````````````````````````````````````````````````````````````````````````````````````````````````````````````````````````````````````#`````````````````````````````````````````````````````````````````````````````````````````~~ ~~ ~~ ~~ ~~ ~~ ~~ ~~ ~~ ~~ ~~ ~~ ~~
7^```````````````````````````````````````````````````````````````````````````````````````````````````````````````````````````````````````````#``````````````````````````````````````````````````````````````````````````````````````~~ ~~ ~~ ~~ ~~ ~~ ~~ ~~ ~~ ~~ ~~ ~~ ~~
7^7````````````````````````````````````````````````````````````````````````````````````````````````````````````````````````````````````#````````````````````````````````````````````````````````````````````````````````````````````~~ ~~ ~~ ~~ ~~ ~~ ~~ ~~ ~~ ~~ ~~ ~~ ~ 
7^````````````````````````````````````````````````````````````````````````````````````````````````````````````````````````````````````#`#`#``````````````````````````````````````````````````````````````````````````````````````````~~ ~~ ~~ ~~ ~~ ~~ ~~ ~~ ~~ ~~ ~~ ~~ ~
7^`````````````````````````````````````````````````````````````````````````````````````````````````````````````````````````````````````````````````````````````````````````````````````````````````````````````````````````````````````~~ ~~ ~~ ~~ ~~ ~~ ~~ ~~ ~~ ~~ ~~ ~~ ~
7^^^^7```````````````````````````````````````````````````````````````````````````````````````````````````````````````````````````````````````````````````````````````````````````````````````````````````````````````````````````````~~ ~~ ~~ ~~ ~~ ~~ ~~ ~~ ~~ ~~ ~~ ~~ ~
7^7^^^7^7^^7```````````````````````````````````````````````````````````````````````````````````````````````````````````````#``````````````````````````````````````````````````````````````````````````````````````````````````````^^7^7^7~ ~~ ~~ ~~ ~~ ~~ ~~ ~~ ~~ ~~ ~~ ~
7^7^^^^7^7^^7^7^777^7^^^7^7^^```````````````````````````````````````````````````````````````````````````````````````#`````````````#`````````````````````````````````````````````````````````````````````````````````````^^7^7^777^7^^^7^7~ ~~ ~~ ~~ ~~ ~~ ~~ ~~ ~~ ~~ ~~ ~
7^7^7^^^^7^7^^7^7^777^7^^^7^7^^7^7^777^7^^^7^7^^7^7^````````````````````````````````````````````````````````#``````````#``````````````````````````````````````````````````````````````````^^7^7^777^7^^^7^7^^^^7^7^777^7^^^7^7^^^7^7^777 ~ ~~ ~~ ~~ ~~ ~~ ~~ ~~ ~~ ~~ ~~ ~
7^7^7^7^7^777^7^^^7^7^^7^7^777^7^^^7^7^^777^7^^^7^7^^7^7^777^7^^^7^7^^777^7^^^7^7^^7^7^777^7^^^7^7^^77^^^7^^^7^^^7^777^777^7^^^7^7^^7^^^7^^^7^^^7^777^777^7^^^7^7^^7^7^777^7^^^7^7^^777^7^^^7^7^^7^7^777^7^^^7^7^^777^7^^^7^7^^7^7^777^7^^^7^7^^~`~~`~~`~~`~~`~~`~~`~~`~~`~~`~~`
~~ ~~ ~~ ~~ ~~ ~~ ~~ ~~ ~~ ~~ ~~~ ~~ ~~ ~~ ~~ ~~ ~~ ~~ ~~ ~~ ~~~ ~~ ~~ ~~ ~~ ~~ ~~ ~~ ~~ ~~ ~~~ ~~ ~~ ~~ ~~ ~~ ~~ ~~ ~~ ~~ ~~~ ~~ ~~ ~~ ~~ ~~ ~~ ~~ ~~ ~~ ~~~ ~~ ~~ ~~ ~~ ~~ ~~ ~~ ~~ ~~ ~~~ ~~ ~~ ~~ ~~ ~~ ~~ ~~ ~~ ~~ ~~~ ~~ ~~ ~~ ~~ ~~ ~~ ~~ ~~ ~~ ~~~ ~~ ~~ ~~ ~~ ~~ ~~ ~~
~~ ~~ ~~ ~~ ~~ ~~ ~~ ~~ ~~ ~~ ~~~ ~~ ~~ ~~ ~~ ~~ ~~ ~~ ~~ ~~ ~~~ ~~ ~~ ~~ ~~ ~~ ~~ ~~ ~~ ~~ ~~~ ~~ ~~ ~~ ~~ ~~ ~~ ~~ ~~ ~~ ~~~ ~~ ~~ ~~ ~~ ~~ ~~ ~~ ~~ ~~ ~~~ ~~ ~~ ~~ ~~ ~~ ~~ ~~ ~~ ~~ ~~~ ~~ ~~ ~~ ~~ ~~ ~~ ~~ ~~ ~~ ~~~ ~~ ~~ ~~ ~~ ~~ ~~ ~~ ~~ ~~ ~~~ ~~ ~~ ~~ ~~ ~~ 
~~ ~~ ~~ ~~ ~~ ~~ ~~ ~~ ~~ ~~ ~~~ ~~ ~~ ~~ ~~ ~~ ~~ ~~ ~~ ~~ ~~~ ~~ ~~ ~~ ~~ ~~ ~~ ~~ ~~ ~~ ~~~ ~~ ~~ ~~ ~~ ~~ ~~ ~~ ~~ ~~ ~~~ ~~ ~~ ~~ ~~ ~~ ~~ ~~ ~~ ~~ ~~~ ~~ ~~ ~~ ~~ ~~ ~~ ~~ ~~ ~~ ~~~ ~~ ~~ ~~ ~~ ~~ ~~ ~~ ~~ ~~ ~~~ ~~ ~~ ~~ ~~ ~~ ~~ ~~ ~~ ~~ ~~~ ~~ ~~ ~~ ~~ ~~ ~~ ~~ ~~
